1111111111111111111111
10000100000E0000000001
110000010000001C000001
100C0P0000000C00000001
1000001000000000000001
1000010000000000000011
1111111111111111111111